{
  "0": [
    "########################################",
    "##S.................##................##",
    "##...#####...........#.......1........##",
    "##..##...##...................####....##",
    "##.##.....##.................##..##...##",
    "##.#...2.....................#....#...##",
    "##.#........................##....#...##",
    "##.##.....##.......###......##...##...##",
    "##..##...##.......##.##......#####....##",
    "##...#####.......##...##..............##",
    "##..............##.....##.............##",
    "##..............#...3...#.............##",
    "##.....####.....##.....##.............##",
    "##....##..##.....##...................##",
    "##....#....#......#####.......####....##",
    "##....#....#.................##..##...##",
    "##....##..##.................#....#...##",
    "##.....####..................#....#...##",
    "##...........................##..##...##",
    "##............................####....##",
    "########################################"
  ],
  "1": [
    "########################################",
    "##....................................##",
    "##..S..............................1..##",
    "##......##......##....##......##......##",
    "##......##......##....##......##......##",
    "##....................................##",
    "##....................................##",
    "##..##......##............##......##..##",
    "##..##......##.....2......##......##..##",
    "##..........##............##..........##",
    "##....................................##",
    "##....................................##",
    "##..........##............##..........##",
    "##..##......##............##......##..##",
    "##..##......##............##......##..##",
    "##....................................##",
    "##....................................##",
    "##......##......##....##......##......##",
    "##......##......##....##...3..##......##",
    "##....................................##",
    "########################################"
  ],
  "2": [
    "########################################",
    "##S..##...................##..........##",
    "##...##...................##....1.....##",
    "##...##...................##..........##",
    "##...##.......#####.......##..........##",
    "##............#...#.......##...####...##",
    "##............#...#............#..#...##",
    "###############...##############..#...##",
    "##................................#...##",
    "##................................#...##",
    "###############...##############..#...##",
    "##............#...#............#..#...##",
    "##............#...#.......##...####...##",
    "##...##.......#####.......##..........##",
    "##...##...................##....2.....##",
    "##...##...................##..........##",
    "##...##...................##..........##",
    "##...##...................##..........##",
    "##...##...3...............##..........##",
    "##........................##..........##",
    "########################################"
  ],
  "3": [
    "########################################",
    "##....................................##",
    "##.S..###############################.##",
    "##....................................##",
    "##.#####################################",
    "##....................................##",
    "#####################################.##",
    "##....................................##",
    "##.#####################################",
    "##...................1................##",
    "#####################################.##",
    "##....................................##",
    "##.#####################################",
    "##....................................##",
    "#####################################.##",
    "##....................................##",
    "##.#####################################",
    "##...................................2##",
    "########################################",
    "########################################",
    "########################################"
  ]
}